УУУ	Фен
УУЦ	Фен
УУА	Лей
УУГ	Лей
УЦУ	Сер
УЦЦ	Сер
УЦА	Сер
УЦГ	Сер
УАУ	Тир
УАЦ	Тир
УАА	___
УАГ	___
УГУ	Цис
УГЦ	Цис
УГА	___
УГГ	Трп
ЦУУ	Лей
ЦУЦ	Лей
ЦУА	Лей
ЦУГ	Лей
ЦЦУ	Про
ЦЦЦ	Про
ЦЦА	Про
ЦЦГ	Про
ЦАУ	Гис
ЦАЦ	Гис
ЦАА	Глн
ЦАГ	Глн
ЦГУ	Арг
ЦГЦ	Арг
ЦГА	Арг
ЦГГ	Арг
АУУ	Иле
АУЦ	Иле
АУА	Иле
АУГ	Мет
АЦУ	Тре
АЦЦ	Тре
АЦА	Тре
АЦГ	Тре
ААУ	Асн
ААЦ	Асн
ААА	Лиз
ААГ	Лиз
АГУ	Сер
АГЦ	Сер
АГА	Арг
АГГ	Арг
ГУУ	Вал
ГУЦ	Вал
ГУА	Вал
ГУГ	Вал
ГЦУ	Ала
ГЦЦ	Ала
ГЦА	Ала
ГЦГ	Ала
ГАУ	Асп
ГАЦ	Асп
ГАА	Глу
ГАГ	Глу
ГГУ	Гли
ГГЦ	Гли
ГГА	Гли
ГГГ Гли